4 0 7 0 0 0 0 7 0 0 0 0 0 0 0 0 7 0 0 0 7 0 7 0 0 0 7 0 0 0 7 0 0
0 0 0 0 0 0 0 0 0 7 0 0 0 7 0 5 5 7 0 0 0 0 0 7 0 0 7 0 0 0 0 0 0
0 0 0 0 0 0 0 0 0 0 0 7 0 0 0 0 0 0 0 0 0 7 0 0 0 0 0 0 0 0 0 0 0
0 0 7 0 0 0 0 7 0 0 0 0 0 0 0 0 7 0 0 0 7 0 7 0 0 0 7 0 0 0 7 0 0
0 0 0 0 0 0 0 0 0 7 0 0 0 7 0 5 5 7 0 0 0 0 0 7 0 0 7 0 0 0 0 0 0
0 5 0 0 7 0 0 7 0 0 0 7 0 0 5 7 0 5 7 0 0 0 0 0 7 0 0 0 7 0 0 0 0
0 0 0 0 0 0 0 0 0 7 0 0 0 0 7 0 0 0 0 7 0 7 0 0 0 0 0 0 0 0 0 0 0
0 0 7 0 0 0 1 2 5 5 5 5 5 5 5 5 5 5 5 5 5 5 5 5 1 2 0 0 5 0 7 0 0
0 0 0 0 7 0 3 4 8 8 8 8 8 8 8 8 8 8 8 8 8 8 8 8 3 4 0 0 7 5 0 0 0
0 0 5 0 0 0 5 8 0 0 0 0 0 0 0 0 0 0 0 0 0 0 0 0 8 5 0 0 0 0 0 0 0
0 3 0 5 7 0 5 8 0 0 0 0 0 0 0 0 0 0 0 0 0 0 0 0 8 5 0 0 0 0 0 0 0
0 0 0 6 0 0 5 8 0 0 8 8 8 8 0 0 0 0 8 8 8 8 0 0 8 5 0 0 5 0 0 7 0
0 0 0 0 0 0 5 8 0 0 8 0 0 0 0 0 0 0 0 0 0 8 0 0 8 5 0 5 5 7 0 0 0
0 0 7 0 0 0 5 8 0 6 8 0 0 0 0 0 0 0 0 0 0 8 0 0 8 5 0 0 7 0 0 0 0
0 0 0 0 7 0 5 8 0 0 0 0 0 0 5 5 5 5 0 0 0 0 0 0 8 5 0 0 0 0 0 0 0
0 0 0 7 0 0 5 8 0 0 0 0 0 0 5 5 5 5 0 0 0 0 0 0 8 5 0 7 0 0 0 0 0
0 5 0 5 0 0 5 8 0 0 0 0 0 0 5 5 5 5 0 0 0 0 0 0 8 5 0 0 5 7 5 7 0
0 0 5 7 0 0 5 8 0 0 0 0 0 0 5 5 5 5 0 0 0 0 0 0 8 5 0 7 0 5 0 0 0
5 7 0 5 0 0 5 8 0 0 8 0 0 0 0 0 0 0 0 0 0 8 0 0 8 5 0 0 5 0 5 0 0
0 0 0 0 0 0 5 8 0 6 8 0 0 0 0 0 0 0 0 0 0 8 0 0 8 5 0 0 7 0 0 7 0
0 7 0 0 0 0 5 8 0 0 8 8 8 8 0 0 0 0 8 8 8 8 0 0 8 5 0 0 0 0 0 0 0
0 0 0 7 0 0 5 8 0 0 0 0 0 0 0 0 0 0 0 0 0 0 0 0 8 5 0 0 0 7 0 0 0
0 7 0 0 0 0 5 8 0 0 0 0 0 0 0 0 0 0 0 0 0 0 0 0 8 5 0 7 0 0 0 7 0
0 0 0 7 0 0 1 2 8 8 8 8 8 8 8 8 8 8 8 8 8 8 8 8 1 2 0 0 0 7 0 0 0
0 0 5 0 0 0 3 4 5 5 5 5 5 5 5 5 5 5 5 5 5 5 5 5 3 4 0 0 0 0 0 0 0
0 0 7 5 0 0 0 0 0 0 0 0 0 0 0 7 0 0 0 0 0 7 0 0 0 0 0 0 0 0 0 0 0
0 0 0 0 0 0 0 7 0 0 7 0 0 0 5 0 0 5 0 0 0 7 0 0 7 0 5 5 0 0 7 0 0
0 0 7 0 0 0 7 0 0 0 0 0 7 0 7 5 5 0 0 0 0 0 7 0 0 0 0 7 5 7 0 0 0
0 0 0 0 7 0 0 7 0 0 7 0 0 0 0 0 0 7 0 0 0 7 0 0 7 0 0 0 0 0 0 0 0
0 7 0 0 0 0 0 0 7 0 0 0 0 0 0 7 0 0 0 0 0 0 0 0 0 0 7 0 0 0 0 0 0
0 0 0 0 7 0 0 7 0 7 0 0 0 0 0 0 0 7 0 0 0 7 0 0 7 0 0 0 0 0 0 0 0